10
10
##########
#   ###  #
#        #
#  #### ##
##   #  ##
#### # ###
#    #   #
# #####  #
#        #
##########
